11111111111111111111
1P000000000C100001C1
101111101011101101X1
10101010101000110101
10101000101010000001
10101011101011111111
10000000101000000001
11111110101011110101
1C0000000000100001E1
11111111111111111111